4 4 4 4 4 4 4 4 4 4
4 5 2 2 2 2 2 2 2 4
4 2 4 4 4 2 4 4 4 4
4 2 4 2 2 2 2 2 2 4
4 2 4 2 4 4 4 4 4 4
4 2 2 2 2 2 2 2 4 4
4 2 4 4 4 2 4 2 4 4
4 2 2 2 4 2 4 2 2 4
4 2 4 4 4 2 4 4 9 4
4 4 4 4 4 4 4 4 4 4